%%%%%%%%%%%%%
%           %
%         P %
%           %
%           %
%           %
%.          %
%%%%%%%%%%%%%